11111111111111111111
1000000c0011110c0011
1c010010000100000101
10010001000c00001001
1c00p0010000001000E1
11111111111111111111
