11111111111111111111
10p0000c0000000c0011
1c000000000100000101
11100000000c00001011
1c0000001000000000E1
11111111111111111111
