11111111111111111111
10p0000c0000000c0011
1c010000000100000101
10000000000c00001001
1c0000010000000000E1
11111111111111111111
