11111111111111111111
10p00000000000000001
1c000000000000000001
10000000000000000001
1c0000000000000000E1
11111111111111111111
