1111111111111111111
1p00000c0000000c011
1c00000000010000101
11100000000c00c0111
1c000000100000000E1
1111111111111111111
