11111111111111111111
1p000000000000000001
1c00X000000000000001
10000000000000000001
1c0000000000000000E1
11111111111111111111
